0 0 5 5 5 5 5 5 5 5 1 1 1 1 1 1 1 1 1 1 1 6 1 1 1 1 1 1 1 1 1 1
0 0 8 0 0 0 0 0 0 0 0 0 0 0 0 0 0 0 0 0 0 6 0 0 0 0 0 0 0 0 0 1
0 1 1 0 1 2 5 5 5 5 1 0 0 1 0 0 0 0 0 0 0 6 0 0 0 0 0 0 0 0 0 1
0 1 0 -1 0 2 0 0 0 1 1 0 0 1 0 0 0 0 0 0 0 6 0 0 0 0 0 0 0 0 0 1
0 1 0 0 0 2 0 0 0 1 0 0 0 1 0 0 0 0 0 0 0 6 0 0 0 0 0 0 0 0 0 1
0 7 0 0 0 2 0 0 0 1 0 0 0 1 0 0 0 0 0 0 0 6 0 0 0 0 0 0 0 0 0 1
0 7 0 0 0 2 0 0 0 1 0 0 0 1 0 0 0 0 0 0 0 6 0 0 0 0 0 0 0 0 0 1
0 7 0 7 7 2 0 0 0 1 0 0 0 1 0 0 0 0 0 0 0 6 0 0 0 0 0 0 0 0 0 1
0 1 0 1 1 1 1 1 2 2 2 0 0 2 0 0 0 0 0 0 0 6 0 0 0 0 0 0 0 0 0 1
0 1 0 0 0 0 0 0 0 0 0 0 0 2 0 0 0 0 0 0 0 6 0 0 0 0 0 0 0 0 0 1
0 1 1 1 1 0 1 1 2 2 0 0 0 2 0 0 0 0 0 0 0 6 0 0 0 0 0 0 0 0 0 1
0 6 0 0 0 0 0 0 6 2 0 6 0 2 0 0 0 0 0 0 0 6 0 0 0 0 0 0 0 0 0 1
0 6 0 0 0 0 0 0 6 2 0 6 0 2 0 0 0 0 0 0 0 6 0 0 0 0 0 0 0 0 0 1
0 6 0 0 0 0 0 0 6 2 0 0 0 2 0 0 0 0 0 0 0 6 0 0 0 0 0 0 0 0 0 1
0 6 6 6 6 0 6 6 6 0 2 2 2 2 0 0 0 0 0 0 0 6 0 0 0 0 0 0 0 0 0 1
1 0 0 0 0 6 0 0 0 0 0 0 0 0 0 0 0 0 0 0 0 6 0 0 0 0 0 0 0 0 0 1 
1 0 0 0 0 6 0 0 0 0 0 0 0 0 0 0 0 0 0 0 0 6 0 0 0 0 0 0 0 0 0 1 
1 0 0 0 0 6 0 0 0 0 0 0 0 0 0 0 0 0 0 0 0 6 0 0 0 0 0 0 0 0 0 1 
1 0 0 0 0 6 0 0 0 0 0 0 0 0 0 0 0 0 0 0 0 6 0 0 0 0 0 0 0 0 0 1 
1 0 0 0 0 6 0 0 0 0 0 0 0 0 0 0 0 0 0 0 0 6 0 0 0 0 0 0 0 0 0 1 
1 0 0 0 0 6 0 0 0 0 0 0 0 0 0 0 0 0 0 0 0 0 0 0 0 0 0 0 0 0 0 1 
1 0 0 0 0 6 0 0 0 0 0 0 0 0 0 0 0 0 0 0 0 0 0 0 0 0 0 0 0 0 0 1 
1 0 0 0 0 6 0 0 0 0 0 0 0 0 0 0 0 0 0 0 0 6 0 0 0 0 0 0 0 0 0 1 
1 0 0 0 0 6 0 0 0 0 0 0 0 0 0 0 0 0 0 0 0 6 0 0 0 0 0 0 0 0 0 1 
1 0 0 0 0 6 0 0 0 0 0 0 0 0 0 0 0 0 0 0 0 6 0 0 0 0 0 0 0 0 0 1 
1 0 0 0 0 6 0 0 0 0 0 0 0 0 0 0 0 0 0 0 0 6 0 0 0 0 0 0 0 0 0 1 
1 0 0 0 0 6 0 0 0 0 0 0 0 0 0 0 0 0 0 0 0 6 0 0 0 0 0 0 0 0 0 1 
1 0 0 0 0 6 0 0 0 0 0 0 0 0 0 0 0 0 0 0 0 6 0 0 0 0 0 0 0 0 0 1 
1 0 0 0 0 6 0 0 0 0 0 0 0 0 0 0 0 0 0 0 0 6 0 0 0 0 0 0 0 0 0 1 
1 0 0 0 0 6 0 0 0 0 0 0 0 0 0 0 0 0 0 0 0 6 0 0 0 0 0 0 0 0 0 1 
1 0 0 0 0 6 0 0 0 0 0 0 0 0 0 0 0 0 0 0 0 6 0 0 0 0 0 0 0 0 0 1 
1 1 1 1 1 6 1 1 1 1 1 1 1 1 1 1 1 1 1 1 1 6 1 1 1 1 1 1 1 1 1 1 
