0 0 9 9 9 9 9 9 9 9 1 1 1 1 0 0 
0 0 9 0 0 0 0 0 0 0 0 0 0 1 0 0 
0 7 7 0 7 7 9 9 9 9 1 0 0 1 0 0 
0 7 0 -1 0 7 0 0 0 1 1 0 0 1 0 0 
0 7 0 0 0 7 0 0 0 1 0 0 0 1 0 0 
0 7 0 0 0 7 0 0 0 1 0 0 0 1 0 0 
0 7 0 0 0 7 0 0 0 1 0 0 0 1 0 0 
0 7 0 7 7 7 0 0 0 1 0 0 0 1 0 0 
0 1 0 1 1 1 1 1 8 8 8 0 0 8 0 0 
0 1 0 0 0 0 0 0 0 0 0 0 0 8 0 0 
0 1 1 1 1 0 1 1 8 8 0 0 0 8 0 0 
0 6 0 0 0 0 0 0 6 8 0 6 0 8 0 0 
0 6 0 0 0 0 0 0 6 8 0 6 0 8 0 0 
0 6 0 0 0 0 0 0 6 8 0 0 0 8 0 0 
0 6 6 6 6 0 6 6 6 8 8 8 8 8 0 0 
0 0 0 0 0 6 0 0 0 0 0 0 0 0 0 0 
